***************************************************
P   *       *       *   *   *   * *         *     *
* *** ***** * * *** * * *** * * * * ******* ***** *
*   * *   * * *   * * *     * *   *   *   *       *
*** * * * * * *** * * *** *** *** *** *** ******* *
* *   * *   * *   * * * *   * *     *   *         *
* ******* *** ***** * * *** * * * * *** *** *** ***
*       *   * *   * *     *   * * *   * *   *   * *
* ***** *** * * * * ***** ***** * * *** ***** *** *
*     * * * * * *   *   * *   * * *   *   *   *   *
***** * * * * * ***** * * * * *** *** *** * *** * *
*   * * * * * * *   * * * * *       *     *     * *
* * * * * * * * * * * * * ******* * ************* *
* * * *   *   *   *   * *   *     *     *         *
* *** ********* ******* *** * ********* ******* ***
*   * *         *           *   *       *     *   *
*** * * *********************** * ******* *** *** *
*   *   *       *               * *       *   * * *
* ************* * *************** * ***** * *** * *
*         *       *   *     *   * *   * * *   *   *
* ******* * * ***** * * *** * * * *** * * *** *****
*       * * *       * *   * * * * *   *   * *     *
******* * *********** * *** * * * *** * *** * *****
*   *   *             *   *   * *     *   * *     *
* * * * * *************** *************** * * *** *
* * * * *   *       *       *             *   *   *
*** * ***** * ***** ******* *** *************** ***
*   *   *   * *     *     * *             *   *   *
* * *** * *** * ***** *** * * *********** * * *** *
* *     *     *       *   *   *           * *     T
***************************************************
