*******************************************************************************************
P  *     *        *        *     *     *           *                 *        *        *  *
*  *  *  *  *******  ****  *  *  ****  *  **********  *  **********  *  ****  *  ****  *  *
*     *  *        *  *  *     *     *  *  *           *  *     *     *     *     *     *  *
*******  *******  *  *  **********  *  *  *  ****  ****  *  *  ****************  *******  *
*        *     *  *        *        *  *        *     *  *  *                 *        *  *
*  *******  *  *  ****  *  *  *******  *************  *  *  ****************  *******  *  *
*  *     *  *  *  *     *  *        *  *        *  *  *  *  *     *        *        *     *
*  *  *  *  *  *  *  ****  ****  *  *  *  ****  *  *  *  ****  *  *  ****  *  *******  ****
*     *  *  *     *  *  *     *  *  *  *  *     *     *        *  *  *     *     *     *  *
*******  *  *******  *  ****  *  *  *  *  *******************  *  *  *  *******  *  ****  *
*  *     *        *     *     *  *     *  *           *        *  *  *     *              *
*  *  **********  *******  ****  *******  *  *******  **********  *  ****  *  *  **********
*  *           *     *     *     *     *     *     *     *        *     *     *  *     *  *
*  *  *******  *  *  ****  *  *******  **********  ****  *  ****  *  **********  *  *  *  *
*  *        *     *  *     *  *     *  *                 *  *     *  *        *     *     *
*  *  *******  *******  *  *  ****  *  *  *******  **********  ****  *  ****  ****  ****  *
*  *  *        *        *  *  *     *           *     *        *     *     *     *     *  *
*  *  *  *************  *  *  *  *******  ****  ****  *  *******************  *  ****  ****
*  *  *  *     *        *  *  *     *     *  *  *     *  *     *           *  *     *     *
*  ****  *  *  *  **********  *  *  *  ****  *  *  ****  *  *  *  *******  *******  ****  *
*        *  *  *     *     *     *  *  *  *     *           *  *  *     *        *     *  *
*  *******  *  ****  *  *  *******  *  *  ****  *******  ****  ****  *  *******  ****  *  *
*  *        *  *     *  *           *  *        *           *        *     *  *        *  *
*  *  *******  *  **********  *******  **********  **********************  *  *******  *  *
*  *        *  *        *  *     *        *     *     *           *     *  *     *     *  *
*  *******  *  *******  *  ****  ****  ****  *  ****  *  **********  *  *  ****  *  ****  *
*        *  *  *        *           *  *     *  *  *  *     *        *     *        *     *
*******  *  *  *  ****************  *  *  ****  *  *  *  ****  **********  *  *******  *  *
*     *     *  *  *        *     *  *        *  *     *     *     *     *  *  *     *  *  *
*  *  *******  *  *******  *  *  *  ****  *  *  *******  *  ****  *  *  ****  *  *  *  *  *
*  *     *     *  *           *  *  *     *  *     *     *        *  *  *     *  *     *  *
*  ****  *  ****  *  ****  ****  *  *  ****  *  ****  ****************  *  *  *  *******  *
*     *  *        *     *     *  *  *     *  *     *  *                 *  *  *  *        *
****  *************  *  ****  ****  *******  ****  *  *  *************  *  ****  *******  *
*     *        *     *     *           *        *  *  *  *           *  *     *     *     *
*  ****  ****  *  ****  *******  *  *  *  ****  *  *  *  *  **********  ****  ****  *  ****
*        *  *     *  *        *  *  *     *     *  *  *     *           *     *     *     *
****  *  *  *******  *******  ****  *******  ****  *  *******  *************  *  **********
*     *  *        *           *     *           *  *  *     *  *           *  *  *        *
*  *************  *  **********  *******  *******  *  *  *  *  *  *******  *  *  *  ****  *
*  *           *  *  *           *     *     *     *     *     *  *        *  *  *     *  *
*  *  **********  ****  *  *******  *  ****  *  ****************  *  *******  *  ****  *  *
*  *  *     *        *  *     *     *  *     *           *        *           *  *     *  *
****  *  *  *  ****  *******  *  *******  *  *  *******  *  ****  *************  *  ****  *
*     *  *  *     *  *        *  *     *  *  *     *     *     *           *           *  *
*  *******  ****  *  *  *******  *  *  *  *  *  ****  ****  *  *******  *  *  **********  *
*     *           *  *  *     *     *     *  *     *     *  *  *     *  *  *  *        *  *
****  *  ****  *******  *  *  *  ****************  ****  *  *  ****  *  *  *  *  ****  *  *
*  *     *  *           *  *  *     *           *     *  *  *        *  *     *  *     *  *
*  *******  *************  *  ****  **********  ****  *  *  **********  *******  *  ****  *
*        *  *  *     *  *  *     *           *        *  *  *        *     *     *  *  *  *
*  ****  *  *  *  *  *  *  ****  *******  *  **********  *  *  *  *  *******  ****  *  *  *
*     *        *  *  *  *  *  *           *     *  *     *     *  *        *     *  *     *
*  *  ****  *  *  *  *  *  *  ****************  *  *  *  ****************  ****  *  *******
*  *  *     *     *     *           *  *     *  *     *     *  *              *  *  *     *
****  *  *************************  *  *  ****  *  *******  *  *  *************  *  ****  *
*     *  *     *     *     *        *           *     *        *                 *     *  *
*  ****  ****  *  *  *  *  *  **********************  **********  *  ****************  *  *
*  *     *        *  *  *  *              *     *  *           *  *     *           *     *
*  *  ****  *  ****  *  *  ****  *******  ****  *  **********  *  *******  *******  ****  *
*  *  *     *  *     *  *        *     *        *              *        *        *  *     *
*  ****  ****  *  ****  **********  *  *******************************  *******  ****  ****
*        *     *     *     *        *  *                 *              *     *     *     *
*  *************  *  ****  *  *******  *  *******  *******  *************  *  ****  ****  *
*           *     *        *  *        *  *        *     *  *           *  *     *  *     *
**********  *  *************  *  *******  *  *******  *  *  *  *******  *  *  ****  *  ****
*           *  *     *        *     *     *           *     *     *     *  *  *     *     *
*  *************  *  *  **********  *  ****************  ****  *  *  ****  ****  *  ****  *
*  *              *  *     *  *     *  *                 *     *  *  *     *     *        *
*  *  *************  ****  *  *  ****  *  **********************  *  ****  *  ****  *  ****
*     *     *     *     *  *  *        *  *     *     *     *     *     *     *     *     *
*******  *  *  *******  *  *  *******  *  *  *  *  *  *  *  *  *******  *******  *******  *
*        *  *  *        *  *  *     *  *  *  *     *  *  *  *  *        *        *     *  *
*  *******  *  *  *******  *  *  *  *  *  *******  *  *  *  *  *  *******  *******  *  ****
*     *  *     *              *  *  *  *           *  *  *     *        *     *  *  *     *
****  *  **********************  ****  *************  *  **********  *  ****  *  *  *  *  *
*  *  *     *        *     *     *     *     *     *  *  *  *        *  *  *  *     *  *  *
*  *  *  ****  ****  *  *  *  *  *  *******  *  *  *  *  *  *  *******  *  *  *  ****  *  *
*  *  *           *  *  *  *  *     *     *  *  *     *  *     *     *     *  *  *     *  *
*  *  *  *******  ****  *  *  *******  *  *  *  *******  *******  *  *******  *  *  ****  *
*     *     *     *     *     *        *     *     *     *     *  *        *     *  *     *
*  *******  *******  **********  ****  **********  *  *******  *  *******  *******  *  ****
*  *     *           *        *     *     *        *  *        *        *     *     *  *  *
*  *  *  *************  ****  ****  *******  *******  ****  **********  ****  *  ****  *  *
*     *     *        *     *  *  *     *           *     *  *  *     *     *  *  *     *  *
****  *******  *  *  ****  *  *  ****  *  *  ****  ****  *  *  *  *  ****  ****  *  ****  *
*     *        *  *        *  *  *  *     *     *  *     *        *  *  *        *  *     *
*  ****  *******  **********  *  *  **********  *  ****  ****  ****  *  **********  *  ****
*     *        *  *        *  *                 *        *     *     *     *        *     *
****  ****  *  *  *  *  *  *  **********  ****************  *******  ****  *  **********  *
*     *     *  *     *  *  *  *     *     *           *     *     *     *     *           *
*  **********  *******  *  *  ****  ****  **********  *  ****  *  ****  *******  *  *******
*  *           *     *  *  *     *  *              *  *  *     *     *        *  *        *
*  ****  *  ****  *  *  *  ****  *  *  *  ****  ****  *  *  ****  *  *  *******  *******  *
*        *  *     *  *  *  *  *        *     *        *  *  *     *  *  *     *     *     *
*************  ****  *  *  *  *************  *************  *  *  *  *  *  *  ****  *  ****
*  *           *  *     *     *                             *  *  *  *  *  *     *  *  *  *
*  *  **********  *  **********  ****  ****  ****************  *  ****  *  ****  *  *  *  *
*        *     *     *           *        *        *     *     *     *  *  *     *  *  *  *
****  *  ****  *******  **********  *************  *  *  **********  *  *  *  ****  *  *  *
*  *  *     *  *     *  *        *  *        *  *     *           *  *     *        *     *
*  *  ****  *  *  *  *  ****  *  *  *  ****  *  *************  ****  *  *  *******  *******
*     *  *  *  *  *     *     *  *        *  *  *        *     *     *  *     *     *     *
*******  *  *  *  *******  ****************  *  *  ****  ****  *  **********  *  ****  *  *
*        *     *     *     *  *     *     *  *     *  *        *  *        *  *  *     *  *
*  *  *************  *  ****  *  *  *  *  *  *******  **********  *  ****  *  *  *******  *
*  *     *  *     *  *           *     *     *     *        *  *  *     *     *        *  *
*  ****  *  *  *  *  *  **********************  *  *******  *  *  *  **********  ****  *  *
*  *  *        *  *  *  *     *                 *  *        *  *     *           *     *  *
*  *  ****  *  ****  *  *  *  *************  ****  *  *******  *******  **********  ****  *
*  *  *     *        *  *  *                 *     *     *     *        *        *  *     *
*  *  *  *******  ****  *  *******************  ****  *  *  ****  ****  *  *  *  *  *  ****
*     *  *  *     *     *     *                 *     *  *  *     *        *  *  *        *
*******  *  *  ****  *******  *  *******  *******  *  *  *  *  ****  **********  *******  *
*     *     *     *  *        *  *     *  *     *  *  *     *     *  *        *  *        *
*  *  **********  ****  *******  *  *  *  *  ****  *  ****  ****  ****  ****  *  **********
*  *           *              *  *  *  *  *  *     *     *     *        *     *     *     *
*  **********  ****************  *  *  *  *  *  *******  *  *************  ****  *  *  *  *
*           *                    *  *     *     *        *                 *     *     *  T
*******************************************************************************************
