**************************************************
*******                              ******** ****
******* ************** ************* ******** ****
******* ************** ***         * ***      ****
P       ************** **  ******  * *** **** ****
******* ***         ** *  *******        **** ****
******* *** ******* **    ******************* ****
******* *** ******* **    ******************* ****
******* *** ******* ************************* ****
******* *** **                     ********** **** 
***     *** ** **** **** ******************** ****
*** ********** **** ****               ****** ****
*** ********** **** ************************* ****
*** ********** **** ************************* ****
***            **** ************ ************ **** 
******** ********** ************ ************ ****
******** ********** ************      ******* ****
********      ***** ************ **** ******* ****
*******************              **** ******* ****
************************************* ******* ****
********************************************* ****
*************************************            T
**************************************************
